.................K

....Z.............

..Z.........######

.................#

......D........P.#